不受幹擾	不受干擾
不幹擾	不干擾
人爲幹擾	人爲干擾
信號幹擾	信號干擾
噪聲幹擾	噪聲干擾
射頻幹擾	射頻干擾
幹撓	干撓
幹擾	干擾
幹擾了	干擾了
幹擾作用	干擾作用
幹擾信號	干擾信號
幹擾到	干擾到
幹擾力	干擾力
幹擾器	干擾器
幹擾因素	干擾因素
幹擾機	干擾機
幹擾源	干擾源
幹擾素	干擾素
抗幹擾	抗干擾
抗幹擾性	抗干擾性
排除幹擾	排除干擾
會幹擾	會干擾
能幹擾	能干擾
電子幹擾	電子干擾
電磁幹擾	電磁干擾
高幹擾	高干擾
