一上臺	一上台 一上臺
一下臺	一下台 一下臺
一中一臺	一中一台 一中一臺
一兩臺	一兩台 一兩臺
一臺	一台 一臺
一臺主機	一台主機 一臺主機
一臺戲	一台戲 一臺戲
一臺服務器	一台服務器 一臺服務器
一臺臺	一台台 一臺臺
一臺車	一台車 一臺車
一臺電腦	一台電腦 一臺電腦
七臺	七台 七臺
七臺河	七台河 七臺河
七臺河市	七台河市 七臺河市
丈八燈臺	丈八燈台 丈八燈臺
三仙臺	三仙台 三仙臺
三個女人一臺戲	三個女人一台戲 三個女人一臺戲
三尺講臺	三尺講台 三尺講臺
三思臺	三思台 三思臺
三臺	三台 三臺
三臺聯播	三台聯播 三臺聯播
上不了臺面	上不了台面 上不了臺面
上不得臺盤	上不得台盤 上不得臺盤
上斷頭臺	上斷頭台 上斷頭臺
上海電視臺	上海電視台 上海電視臺
上臺	上台 上臺
上臺前	上台前 上臺前
上臺執政	上台執政 上臺執政
上臺後	上台後 上臺後
上臺演唱	上台演唱 上臺演唱
上臺演奏	上台演奏 上臺演奏
上臺演講	上台演講 上臺演講
上臺階	上台階 上臺階
上臺面	上台面 上臺面
上舞臺	上舞台 上舞臺
上花臺	上花台 上花臺
下不了臺	下不了台 下不了臺
下不來臺	下不來台 下不來臺
下臺	下台 下臺
下臺一鞠躬	下台一鞠躬 下臺一鞠躬
下臺階	下台階 下臺階
不上臺盤	不上台盤 不上臺盤
不上臺面	不上台面 不上臺面
不得臺盤	不得台盤 不得臺盤
世界舞臺	世界舞台 世界舞臺
世臺	世台 世臺
世臺會	世台會 世臺會
中國中央電視臺	中國中央電視台 中國中央電視臺
中國國際廣播電臺	中國國際廣播電台 中國國際廣播電臺
中國地震臺	中國地震台 中國地震臺
中國臺北	中國台北 中國臺北
中國臺灣	中國台灣 中國臺灣
中央人民廣播電臺	中央人民廣播電台 中央人民廣播電臺
中央廣播電臺	中央廣播電台 中央廣播電臺
中央氣象臺	中央氣象台 中央氣象臺
中央臺	中央台 中央臺
中央電視臺	中央電視台 中央電視臺
中控臺	中控台 中控臺
中文平臺	中文平台 中文平臺
中文臺	中文台 中文臺
中港臺	中港台 中港臺
中臺	中台 中臺
中臺灣	中台灣 中臺灣
中臺灣地區	中台灣地區 中臺灣地區
中臺產品	中台產品 中臺產品
中臺禪寺	中台禪寺 中臺禪寺
中臺科技大學	中台科技大學 中臺科技大學
中臺醫事技術專科學校	中台醫事技術專科學校 中臺醫事技術專科學校
中臺醫專	中台醫專 中臺醫專
中臺醫護技術學院	中台醫護技術學院 中臺醫護技術學院
中華臺北	中華台北 中華臺北
中華電視臺	中華電視台 中華電視臺
串臺	串台 串臺
串臺了	串台了 串臺了
丹臺	丹台 丹臺
主席臺	主席台 主席臺
主控臺	主控台 主控臺
主播臺	主播台 主播臺
九臺	九台 九臺
九臺市	九台市 九臺市
乾撂臺	乾撂台 乾撂臺
二人臺	二人台 二人臺
二臺	二台 二臺
于臺煙	于台煙 于臺煙
互動平臺	互動平台 互動平臺
互動臺	互動台 互動臺
五臺	五台 五臺
五臺山	五台山 五臺山
五臺市	五台市 五臺市
五臺縣	五台縣 五臺縣
井臺	井台 井臺
交友平臺	交友平台 交友平臺
交易平臺	交易平台 交易平臺
交易臺	交易台 交易臺
交流平臺	交流平台 交流平臺
交通臺	交通台 交通臺
亭臺	亭台 亭臺
亭臺樓榭	亭台樓榭 亭臺樓榭
亭臺樓閣	亭台樓閣 亭臺樓閣
人民廣播電臺	人民廣播電台 人民廣播電臺
人生舞臺	人生舞台 人生舞臺
仙臺	仙台 仙臺
任憑風浪起穩坐釣魚臺	任憑風浪起穩坐釣魚台 任憑風浪起穩坐釣魚臺
佔臺	佔台 佔臺
作業平臺	作業平台 作業平臺
來自臺灣	來自台灣 來自臺灣
來臺	來台 來臺
來臺訪問	來台訪問 來臺訪問
信息平臺	信息平台 信息平臺
信號臺	信號台 信號臺
倒臺	倒台 倒臺
做臺	做台 做臺
偵聽臺	偵聽台 偵聽臺
債臺高築	債台高築 債臺高築
儀表臺	儀表台 儀表臺
兄臺	兄台 兄臺
克孜爾尕哈烽火臺	克孜爾尕哈烽火台 克孜爾尕哈烽火臺
克隆斯臺	克隆斯台 克隆斯臺
兒童臺	兒童台 兒童臺
內臺	內台 內臺
全臺	全台 全臺
全臺灣	全台灣 全臺灣
兩臺	兩台 兩臺
兩臺機器	兩台機器 兩臺機器
兩臺電腦	兩台電腦 兩臺電腦
八臺	八台 八臺
公衆平臺	公衆平台 公衆平臺
六臺	六台 六臺
出納臺	出納台 出納臺
出臺	出台 出臺
出臺了	出台了 出臺了
出臺後	出台後 出臺後
初舞臺	初舞台 初舞臺
制定出臺	制定出台 制定出臺
制臺	制台 制臺
前後臺	前後台 前後臺
前臺	前台 前臺
前臺接待	前台接待 前臺接待
前臺服務	前台服務 前臺服務
前臺開發	前台開發 前臺開發
前臺頁面	前台頁面 前臺頁面
副臺長	副台長 副臺長
劉阮上天臺	劉阮上天台 劉阮上天臺
勞臺重	勞台重 勞臺重
化妝臺	化妝台 化妝臺
化驗臺	化驗台 化驗臺
北京豐臺	北京豐台 北京豐臺
北京電視臺	北京電視台 北京電視臺
十米臺	十米台 十米臺
十米跳臺	十米跳台 十米跳臺
十臺	十台 十臺
千臺	千台 千臺
升降臺	升降台 升降臺
半島電視臺	半島電視台 半島電視臺
協作平臺	協作平台 協作平臺
南山有臺	南山有台 南山有臺
南臺	南台 南臺
南臺工專	南台工專 南臺工專
南臺灣	南台灣 南臺灣
南臺科技大學	南台科技大學 南臺科技大學
印臺	印台 印臺
印臺區	印台區 印臺區
厄臺	厄台 厄臺
去後臺	去後台 去後臺
去收銀臺	去收銀台 去收銀臺
去臺	去台 去臺
去臺人員	去台人員 去臺人員
友臺	友台 友臺
叢臺	叢台 叢臺
叢臺區	叢台區 叢臺區
古琴臺	古琴台 古琴臺
另一臺	另一台 另一臺
另外一臺	另外一台 另外一臺
司令臺	司令台 司令臺
司天臺	司天台 司天臺
司馬臺	司馬台 司馬臺
各個平臺	各個平台 各個平臺
合作舞臺	合作舞台 合作舞臺
同臺	同台 同臺
向臺灣	向台灣 向臺灣
含港澳臺	含港澳台 含港澳臺
吹臺	吹台 吹臺
周臺竹	周台竹 周臺竹
呼臺	呼台 呼臺
咍臺	咍台 咍臺
品蓮臺	品蓮台 品蓮臺
哪一臺	哪一台 哪一臺
哪臺	哪台 哪臺
售臺	售台 售臺
售貨臺	售貨台 售貨臺
唱對臺戲	唱對台戲 唱對臺戲
商務平臺	商務平台 商務平臺
商業電臺	商業電台 商業電臺
喝茅臺	喝茅台 喝茅臺
噓下臺	噓下台 噓下臺
噓下臺來	噓下台來 噓下臺來
噓下臺去	噓下台去 噓下臺去
四方臺	四方台 四方臺
四方臺區	四方台區 四方臺區
四臺	四台 四臺
四號臺	四號台 四號臺
回臺	回台 回臺
國務院臺灣事務辦公室	國務院台灣事務辦公室 國務院臺灣事務辦公室
國營電視臺	國營電視台 國營電視臺
國立教育廣播電臺	國立教育廣播電台 國立教育廣播電臺
國立臺北科技大學	國立台北科技大學 國立臺北科技大學
國立臺灣博物館	國立台灣博物館 國立臺灣博物館
國立臺灣圖書館	國立台灣圖書館 國立臺灣圖書館
國立臺灣技術大學	國立台灣技術大學 國立臺灣技術大學
國臺語	國台語 國臺語
國臺辦	國台辦 國臺辦
國際臺	國際台 國際臺
國際舞臺	國際舞台 國際舞臺
圓臺	圓台 圓臺
圓錐臺	圓錐台 圓錐臺
土臺	土台 土臺
在前臺	在前台 在前臺
在後臺	在後台 在後臺
在窗臺	在窗台 在窗臺
在臺	在台 在臺
在臺上	在台上 在臺上
在臺北	在台北 在臺北
在臺協會	在台協會 在臺協會
在臺灣	在台灣 在臺灣
在舞臺上	在舞台上 在舞臺上
在陽臺	在陽台 在陽臺
地下電臺	地下電台 地下電臺
地方臺	地方台 地方臺
地方電視臺	地方電視台 地方電視臺
地臺	地台 地臺
坍臺	坍台 坍臺
垮臺	垮台 垮臺
基地臺	基地台 基地臺
報臺	報台 報臺
塌臺	塌台 塌臺
塔爾巴哈臺	塔爾巴哈台 塔爾巴哈臺
塔臺	塔台 塔臺
墩臺	墩台 墩臺
壇臺	壇台 壇臺
壓臺	壓台 壓臺
壓臺戲	壓台戲 壓臺戲
壩臺	壩台 壩臺
外臺祕要	外台祕要 外臺祕要
多少樓臺煙雨中	多少樓台煙雨中 多少樓臺煙雨中
多少臺	多少台 多少臺
多平臺	多平台 多平臺
多平臺環境	多平台環境 多平臺環境
多臺	多台 多臺
多臺電腦	多台電腦 多臺電腦
夜臺	夜台 夜臺
大平臺	大平台 大平臺
大愛臺	大愛台 大愛臺
大撫臺	大撫台 大撫臺
大數據平臺	大數據平台 大數據平臺
大沽口炮臺	大沽口炮台 大沽口炮臺
大沽口砲臺	大沽口砲台 大沽口砲臺
大沽炮臺	大沽炮台 大沽炮臺
大沽砲臺	大沽砲台 大沽砲臺
大臺	大台 大臺
大臺北	大台北 大臺北
大臺北區	大台北區 大臺北區
大臺北地區	大台北地區 大臺北地區
大舞臺	大舞台 大舞臺
大舞臺上	大舞台上 大舞臺上
大跳臺	大跳台 大跳臺
天文臺	天文台 天文臺
天臺	天台 天臺
太空天文臺	太空天文台 太空天文臺
奇臺縣	奇台縣 奇臺縣
好平臺	好平台 好平臺
好戲連臺	好戲連台 好戲連臺
妝臺	妝台 妝臺
娛樂平臺	娛樂平台 娛樂平臺
娛樂臺	娛樂台 娛樂臺
媒體平臺	媒體平台 媒體平臺
學習平臺	學習平台 學習平臺
學臺	學台 學臺
官臺木	官台木 官臺木
寅臺	寅台 寅臺
察合臺	察合台 察合臺
察合臺汗國	察合台汗國 察合臺汗國
實驗臺	實驗台 實驗臺
寶島臺灣	寶島台灣 寶島臺灣
封臺	封台 封臺
封陽臺	封陽台 封陽臺
尋呼臺	尋呼台 尋呼臺
對戰平臺	對戰平台 對戰平臺
對臺	對台 對臺
對臺戲	對台戲 對臺戲
對臺灣	對台灣 對臺灣
導航臺	導航台 導航臺
小五臺	小五台 小五臺
小臺	小台 小臺
尿布臺	尿布台 尿布臺
屋頂平臺	屋頂平台 屋頂平臺
展示平臺	展示平台 展示平臺
展示臺	展示台 展示臺
展臺	展台 展臺
展臺上	展台上 展臺上
展臺前	展台前 展臺前
層臺	層台 層臺
山東煙臺	山東煙台 山東煙臺
峯火臺	峯火台 峯火臺
崗臺	崗台 崗臺
工作平臺	工作平台 工作平臺
工作臺	工作台 工作臺
工作臺上	工作台上 工作臺上
巴洛馬天文臺	巴洛馬天文台 巴洛馬天文臺
帕臺農	帕台農 帕臺農
帕臺農神廟	帕台農神廟 帕臺農神廟
平地樓臺	平地樓台 平地樓臺
平臺	平台 平臺
平臺上	平台上 平臺上
平臺使用費	平台使用費 平臺使用費
平臺型	平台型 平臺型
平臺對接	平台對接 平臺對接
平臺式	平台式 平臺式
平臺式掃描器	平台式掃描器 平臺式掃描器
平臺技術	平台技術 平臺技術
平臺搭建	平台搭建 平臺搭建
平臺數	平台數 平臺數
平臺架構	平台架構 平臺架構
平臺移植	平台移植 平臺移植
平臺階段	平台階段 平臺階段
平衡臺	平衡台 平衡臺
年臺	年台 年臺
幾千臺	幾千台 幾千臺
幾臺	幾台 幾臺
幾萬臺	幾萬台 幾萬臺
府臺	府台 府臺
庫里爾臺	庫里爾台 庫里爾臺
廟臺	廟台 廟臺
廣告平臺	廣告平台 廣告平臺
廣播臺	廣播台 廣播臺
廣播電臺	廣播電台 廣播電臺
廣東臺山	廣東台山 廣東臺山
建臺	建台 建臺
強颱聖帕襲臺	強颱聖帕襲台 強颱聖帕襲臺
後臺	後台 後臺
後臺下載	後台下載 後臺下載
後臺任務	後台任務 後臺任務
後臺播放	後台播放 後臺播放
後臺服務器	後台服務器 後臺服務器
後臺監控	後台監控 後臺監控
後臺程序	後台程序 後臺程序
後臺管理	後台管理 後臺管理
後臺線程	後台線程 後臺線程
後臺老闆	後台老闆 後臺老闆
後臺處理	後台處理 後臺處理
後臺語言	後台語言 後臺語言
後臺進程	後台進程 後臺進程
後臺運行	後台運行 後臺運行
後臺開發	後台開發 後臺開發
徐臺蓀	徐台蓀 徐臺蓀
徐臺蓀宮仲毅	徐台蓀宮仲毅 徐臺蓀宮仲毅
御史臺	御史台 御史臺
復興廣播電臺	復興廣播電台 復興廣播電臺
微信公共平臺	微信公共平台 微信公共平臺
微信公衆平臺	微信公衆平台 微信公衆平臺
微信平臺	微信平台 微信平臺
微信開放平臺	微信開放平台 微信開放平臺
微雲臺	微雲台 微雲臺
快速開發平臺	快速開發平台 快速開發平臺
忽里臺大會	忽里台大會 忽里臺大會
恢臺	恢台 恢臺
恩臺	恩台 恩臺
憲臺	憲台 憲臺
應照離人妝鏡臺	應照離人妝鏡台 應照離人妝鏡臺
應用平臺	應用平台 應用平臺
我國臺灣	我國台灣 我國臺灣
戒臺寺	戒台寺 戒臺寺
戲劇臺	戲劇台 戲劇臺
戲臺	戲台 戲臺
戲臺子	戲台子 戲臺子
打印臺	打印台 打印臺
打報臺	打報台 打報臺
打對臺	打對台 打對臺
打擂臺	打擂台 打擂臺
打歌舞臺	打歌舞台 打歌舞臺
找一臺	找一台 找一臺
找臺	找台 找臺
找臺階	找台階 找臺階
找臺階下	找台階下 找臺階下
找臺階兒	找台階兒 找臺階兒
承臺	承台 承臺
抄臺	抄台 抄臺
拆臺	拆台 拆臺
拜臺	拜台 拜臺
拳擊臺	拳擊台 拳擊臺
拳臺	拳台 拳臺
拿一臺	拿一台 拿一臺
指揮臺	指揮台 指揮臺
挑臺	挑台 挑臺
換平臺	換平台 換平臺
換臺	換台 換臺
搭臺	搭台 搭臺
搶茅臺	搶茅台 搶茅臺
撫臺	撫台 撫臺
撫臺街	撫台街 撫臺街
擂臺	擂台 擂臺
擂臺賽	擂台賽 擂臺賽
擂臺賽上	擂台賽上 擂臺賽上
操作平臺	操作平台 操作平臺
操縱臺	操縱台 操縱臺
據臺灣	據台灣 據臺灣
擺擂臺	擺擂台 擺擂臺
支付平臺	支付平台 支付平臺
收復臺灣	收復台灣 收復臺灣
收款臺	收款台 收款臺
收銀臺	收銀台 收銀臺
政治舞臺	政治舞台 政治舞臺
整臺	整台 整臺
敵臺	敵台 敵臺
數據平臺	數據平台 數據平臺
文臺	文台 文臺
料理臺	料理台 料理臺
新出臺的	新出台的 新出臺的
新城電臺	新城電台 新城電臺
新報臺	新報台 新報臺
新聞臺	新聞台 新聞臺
新臺	新台 新臺
新臺幣	新台幣 新臺幣
新臺階	新台階 新臺階
新舞臺	新舞台 新舞臺
斷頭臺	斷頭台 斷頭臺
旋轉臺	旋轉台 旋轉臺
日本臺	日本台 日本臺
明臺	明台 明臺
春臺	春台 春臺
是臺灣人	是台灣人 是臺灣人
晒臺	晒台 晒臺
晾臺	晾台 晾臺
暈臺	暈台 暈臺
曬臺	曬台 曬臺
曲臺	曲台 曲臺
曾臺霖	曾台霖 曾臺霖
會向瑤臺月下逢	會向瑤台月下逢 會向瑤臺月下逢
月臺	月台 月臺
月臺票	月台票 月臺票
有一臺	有一台 有一臺
有兩臺	有兩台 有兩臺
有線電視臺	有線電視台 有線電視臺
有陽臺	有陽台 有陽臺
服務平臺	服務平台 服務平臺
服務臺	服務台 服務臺
望樓臺	望樓台 望樓臺
望臺	望台 望臺
望鄉臺	望鄉台 望鄉臺
本報臺	本報台 本報臺
本臺	本台 本臺
本臺消息	本台消息 本臺消息
杯臺	杯台 杯臺
東臺	東台 東臺
東臺市	東台市 東臺市
東臺灣	東台灣 東臺灣
林口臺地	林口台地 林口臺地
柏梁臺	柏梁台 柏梁臺
柏臺	柏台 柏臺
柏臺烏府	柏台烏府 柏臺烏府
某臺	某台 某臺
查號臺	查號台 查號臺
查詢臺	查詢台 查詢臺
格林威治天文臺	格林威治天文台 格林威治天文臺
格林尼治天文臺	格林尼治天文台 格林尼治天文臺
桃園中壢臺地	桃園中壢台地 桃園中壢臺地
桓臺	桓台 桓臺
桓臺縣	桓台縣 桓臺縣
梁仙臺	梁仙台 梁仙臺
梁山伯祝英臺	梁山伯祝英台 梁山伯祝英臺
梁山伯與祝英臺	梁山伯與祝英台 梁山伯與祝英臺
梳妝臺	梳妝台 梳妝臺
棱臺	棱台 棱臺
棱錐臺	棱錐台 棱錐臺
業餘電臺	業餘電台 業餘電臺
樓梯平臺	樓梯平台 樓梯平臺
樓梯臺	樓梯台 樓梯臺
樓臺	樓台 樓臺
樓臺亭閣	樓台亭閣 樓臺亭閣
樓臺會	樓台會 樓臺會
樓閣亭臺	樓閣亭台 樓閣亭臺
橋臺	橋台 橋臺
機臺	機台 機臺
檢閱臺	檢閱台 檢閱臺
櫃臺	櫃台 櫃臺
歌臺舞榭	歌台舞榭 歌臺舞榭
歌風臺	歌風台 歌風臺
此去泉臺招舊部	此去泉台招舊部 此去泉臺招舊部
歷史舞臺	歷史舞台 歷史舞臺
每一臺	每一台 每一臺
每臺	每台 每臺
氣象臺	氣象台 氣象臺
水流內布袋戲臺	水流內布袋戲台 水流內布袋戲臺
水運儀象臺	水運儀象台 水運儀象臺
沈文臺	沈文台 沈文臺
河北邢臺	河北邢台 河北邢臺
泉臺	泉台 泉臺
法臺	法台 法臺
流理臺	流理台 流理臺
浮臺	浮台 浮臺
海臺	海台 海臺
海蝕平臺	海蝕平台 海蝕平臺
海蝕臺地	海蝕台地 海蝕臺地
涉臺	涉台 涉臺
涼臺	涼台 涼臺
深溝墩臺	深溝墩台 深溝墩臺
清涼臺	清涼台 清涼臺
清理後臺	清理後台 清理後臺
測試臺	測試台 測試臺
港澳臺	港澳台 港澳臺
港澳臺同胞	港澳台同胞 港澳臺同胞
港澳臺地區	港澳台地區 港澳臺地區
港臺	港台 港臺
港臺地區	港台地區 港臺地區
港臺明星	港台明星 港臺明星
港臺歌手	港台歌手 港臺歌手
港臺歌曲	港台歌曲 港臺歌曲
港臺腔	港台腔 港臺腔
港臺電影	港台電影 港臺電影
湖南臺	湖南台 湖南臺
溝通平臺	溝通平台 溝通平臺
演奏臺	演奏台 演奏臺
演講臺	演講台 演講臺
漢臺	漢台 漢臺
漢臺區	漢台區 漢臺區
潛臺詞	潛台詞 潛臺詞
澳洲廣播電臺	澳洲廣播電台 澳洲廣播電臺
澹臺	澹台 澹臺
澹臺滅明	澹台滅明 澹臺滅明
瀛臺	瀛台 瀛臺
炮臺	炮台 炮臺
烏里雅蘇臺	烏里雅蘇台 烏里雅蘇臺
烽火臺	烽火台 烽火臺
無線電臺	無線電台 無線電臺
無線電視臺	無線電視台 無線電視臺
煙臺	煙台 煙臺
煙臺地區	煙台地區 煙臺地區
煙臺大學	煙台大學 煙臺大學
煙臺市	煙台市 煙臺市
煙臺師範學院	煙台師範學院 煙臺師範學院
照臺	照台 照臺
燈臺	燈台 燈臺
燈臺不照自己	燈台不照自己 燈臺不照自己
燈臺不自照	燈台不自照 燈臺不自照
燕昭築臺	燕昭築台 燕昭築臺
燕臺	燕台 燕臺
燭臺	燭台 燭臺
爐臺	爐台 爐臺
父臺	父台 父臺
犯臺	犯台 犯臺
獻臺	獻台 獻臺
玉臺	玉台 玉臺
玉臺新詠	玉台新詠 玉臺新詠
玉臺體	玉台體 玉臺體
玉鏡臺	玉鏡台 玉鏡臺
王臺	王台 王臺
琅琊臺	琅琊台 琅琊臺
琅邪臺刻石	琅邪台刻石 琅邪臺刻石
琴臺	琴台 琴臺
瑤臺	瑤台 瑤臺
瑤臺瓊室	瑤台瓊室 瑤臺瓊室
瑤臺銀闕	瑤台銀闕 瑤臺銀闕
瑤臺鏡	瑤台鏡 瑤臺鏡
璧爐臺	璧爐台 璧爐臺
瓊臺玉宇	瓊台玉宇 瓊臺玉宇
瓊臺玉閣	瓊台玉閣 瓊臺玉閣
用報臺	用報台 用報臺
由臺灣	由台灣 由臺灣
登幽州臺歌	登幽州台歌 登幽州臺歌
登臺	登台 登臺
登臺亮相	登台亮相 登臺亮相
登臺拜將	登台拜將 登臺拜將
登臺演唱	登台演唱 登臺演唱
登臺表演	登台表演 登臺表演
登金陵鳳凰臺	登金陵鳳凰台 登金陵鳳凰臺
發佈平臺	發佈平台 發佈平臺
發射臺	發射台 發射臺
發言臺	發言台 發言臺
百萬臺	百萬台 百萬臺
盥洗臺	盥洗台 盥洗臺
直播平臺	直播平台 直播平臺
相臺	相台 相臺
省道臺	省道台 省道臺
看臺	看台 看臺
看臺上	看台上 看臺上
看臺票	看台票 看臺票
看臺股	看台股 看臺股
眺望臺	眺望台 眺望臺
眺臺	眺台 眺臺
瞭望臺	瞭望台 瞭望臺
短信平臺	短信平台 短信平臺
石臺	石台 石臺
石臺縣	石台縣 石臺縣
砲臺	砲台 砲臺
硬件平臺	硬件平台 硬件平臺
硯臺	硯台 硯臺
社區電臺	社區電台 社區電臺
祈仙臺	祈仙台 祈仙臺
祝英臺	祝英台 祝英臺
神臺	神台 神臺
祭臺	祭台 祭臺
禁忌站臺	禁忌站台 禁忌站臺
禮臺	禮台 禮臺
禹王臺	禹王台 禹王臺
禹王臺區	禹王台區 禹王臺區
秉臺衡	秉台衡 秉臺衡
移動平臺	移動平台 移動平臺
移動廣告平臺	移動廣告平台 移動廣告平臺
移動炮臺	移動炮台 移動炮臺
穩坐釣魚臺	穩坐釣魚台 穩坐釣魚臺
窗臺	窗台 窗臺
窗臺上	窗台上 窗臺上
窩闊臺	窩闊台 窩闊臺
窩闊臺汗	窩闊台汗 窩闊臺汗
窩闊臺汗國	窩闊台汗國 窩闊臺汗國
竈臺	竈台 竈臺
站櫃臺	站櫃台 站櫃臺
站臺	站台 站臺
站臺上	站台上 站臺上
站臺票	站台票 站臺票
章臺	章台 章臺
章臺柳	章台柳 章臺柳
章臺楊柳	章台楊柳 章臺楊柳
第一臺	第一台 第一臺
第一臺車	第一台車 第一臺車
第三方平臺	第三方平台 第三方平臺
第三臺	第三台 第三臺
第二臺	第二台 第二臺
第四臺	第四台 第四臺
管制塔臺	管制塔台 管制塔臺
管理平臺	管理平台 管理平臺
米跳臺	米跳台 米跳臺
系統平臺	系統平台 系統平臺
紫臺	紫台 紫臺
紫金山天文臺	紫金山天文台 紫金山天文臺
絞刑臺	絞刑台 絞刑臺
統一臺灣	統一台灣 統一臺灣
經典臺詞	經典台詞 經典臺詞
經濟臺	經濟台 經濟臺
網站前臺	網站前台 網站前臺
網站後臺	網站後台 網站後臺
網絡平臺	網絡平台 網絡平臺
網絡電臺	網絡電台 網絡電臺
網路平臺	網路平台 網路平臺
網路站臺	網路站台 網路站臺
網際電臺	網際電台 網際電臺
繁臺	繁台 繁臺
美國在臺協會	美國在台協會 美國在臺協會
美臺	美台 美臺
翡翠臺	翡翠台 翡翠臺
聖帕襲臺	聖帕襲台 聖帕襲臺
聖火臺	聖火台 聖火臺
聲訊臺	聲訊台 聲訊臺
育樂臺	育樂台 育樂臺
背臺詞	背台詞 背臺詞
胡裏山炮臺	胡裏山炮台 胡裏山炮臺
自由亞洲電臺	自由亞洲電台 自由亞洲電臺
臺	台 臺
臺一	台一 臺一
臺一線	台一線 臺一線
臺七線	台七線 臺七線
臺三線	台三線 臺三線
臺上	台上 臺上
臺上一分鐘	台上一分鐘 臺上一分鐘
臺上臺下	台上台下 臺上臺下
臺下	台下 臺下
臺下十年功	台下十年功 臺下十年功
臺中	台中 臺中
臺中一中	台中一中 臺中一中
臺中人	台中人 臺中人
臺中區	台中區 臺中區
臺中商專	台中商專 臺中商專
臺中場	台中場 臺中場
臺中市	台中市 臺中市
臺中市人	台中市人 臺中市人
臺中市文	台中市文 臺中市文
臺中師範	台中師範 臺中師範
臺中師範學院	台中師範學院 臺中師範學院
臺中店	台中店 臺中店
臺中教育大學	台中教育大學 臺中教育大學
臺中港	台中港 臺中港
臺中港路	台中港路 臺中港路
臺中盆地	台中盆地 臺中盆地
臺中站	台中站 臺中站
臺中縣	台中縣 臺中縣
臺中縣市	台中縣市 臺中縣市
臺中訊	台中訊 臺中訊
臺九線	台九線 臺九線
臺企	台企 臺企
臺企聯	台企聯 臺企聯
臺企銀	台企銀 臺企銀
臺佟	台佟 臺佟
臺候	台候 臺候
臺光	台光 臺光
臺兒莊	台兒莊 臺兒莊
臺兒莊區	台兒莊區 臺兒莊區
臺兩	台兩 臺兩
臺八線	台八線 臺八線
臺函	台函 臺函
臺前	台前 臺前
臺前幕後	台前幕後 臺前幕後
臺前縣	台前縣 臺前縣
臺前臺後	台前台後 臺前臺後
臺劇	台劇 臺劇
臺勝科	台勝科 臺勝科
臺北	台北 臺北
臺北人	台北人 臺北人
臺北區	台北區 臺北區
臺北商專	台北商專 臺北商專
臺北地理資訊系統	台北地理資訊系統 臺北地理資訊系統
臺北地院	台北地院 臺北地院
臺北城	台北城 臺北城
臺北場	台北場 臺北場
臺北大學	台北大學 臺北大學
臺北客	台北客 臺北客
臺北小	台北小 臺北小
臺北工專	台北工專 臺北工專
臺北工業專科學校	台北工業專科學校 臺北工業專科學校
臺北市	台北市 臺北市
臺北市喜願協會	台北市喜願協會 臺北市喜願協會
臺北市市	台北市市 臺北市市
臺北市政府捷運工程局	台北市政府捷運工程局 臺北市政府捷運工程局
臺北市立	台北市立 臺北市立
臺北市立師範學校	台北市立師範學校 臺北市立師範學校
臺北市立教育大學	台北市立教育大學 臺北市立教育大學
臺北市立體育學院	台北市立體育學院 臺北市立體育學院
臺北市長	台北市長 臺北市長
臺北市隊	台北市隊 臺北市隊
臺北師範學院	台北師範學院 臺北師範學院
臺北師院	台北師院 臺北師院
臺北捷運	台北捷運 臺北捷運
臺北捷運中和線	台北捷運中和線 臺北捷運中和線
臺北捷運新店線	台北捷運新店線 臺北捷運新店線
臺北捷運木柵線	台北捷運木柵線 臺北捷運木柵線
臺北捷運淡水線	台北捷運淡水線 臺北捷運淡水線
臺北橋	台北橋 臺北橋
臺北港	台北港 臺北港
臺北盆地	台北盆地 臺北盆地
臺北科技大學	台北科技大學 臺北科技大學
臺北站	台北站 臺北站
臺北縣	台北縣 臺北縣
臺北縣長	台北縣長 臺北縣長
臺北訊	台北訊 臺北訊
臺北護專	台北護專 臺北護專
臺北護理專科學校	台北護理專科學校 臺北護理專科學校
臺北車站	台北車站 臺北車站
臺北醫學大學	台北醫學大學 臺北醫學大學
臺北醫學院	台北醫學院 臺北醫學院
臺北隊	台北隊 臺北隊
臺北體專	台北體專 臺北體專
臺北體院	台北體院 臺北體院
臺十一線	台十一線 臺十一線
臺十七線	台十七線 臺十七線
臺南	台南 臺南
臺南人	台南人 臺南人
臺南區	台南區 臺南區
臺南大學	台南大學 臺南大學
臺南女子技術學院	台南女子技術學院 臺南女子技術學院
臺南孔廟	台南孔廟 臺南孔廟
臺南家專	台南家專 臺南家專
臺南家政專科學校	台南家政專科學校 臺南家政專科學校
臺南市	台南市 臺南市
臺南師範學院	台南師範學院 臺南師範學院
臺南府	台南府 臺南府
臺南府市	台南府市 臺南府市
臺南科學工業園區	台南科學工業園區 臺南科學工業園區
臺南科技大學	台南科技大學 臺南科技大學
臺南站	台南站 臺南站
臺南縣	台南縣 臺南縣
臺南縣市	台南縣市 臺南縣市
臺司	台司 臺司
臺命	台命 臺命
臺和	台和 臺和
臺商	台商 臺商
臺商圈	台商圈 臺商圈
臺啓	台啓 臺啓
臺啤隊	台啤隊 臺啤隊
臺地	台地 臺地
臺型	台型 臺型
臺城	台城 臺城
臺基	台基 臺基
臺場	台場 臺場
臺塑	台塑 臺塑
臺墩	台墩 臺墩
臺壓版	台壓版 臺壓版
臺大	台大 臺大
臺大學生	台大學生 臺大學生
臺大醫院	台大醫院 臺大醫院
臺女	台女 臺女
臺妹	台妹 臺妹
臺委	台委 臺委
臺媒	台媒 臺媒
臺子	台子 臺子
臺子上	台子上 臺子上
臺子女	台子女 臺子女
臺子孫	台子孫 臺子孫
臺孩	台孩 臺孩
臺孫	台孫 臺孫
臺安	台安 臺安
臺安縣	台安縣 臺安縣
臺客	台客 臺客
臺客嗆辣	台客嗆辣 臺客嗆辣
臺客舞	台客舞 臺客舞
臺尺	台尺 臺尺
臺屬	台屬 臺屬
臺山市	台山市 臺山市
臺峪	台峪 臺峪
臺島	台島 臺島
臺布	台布 臺布
臺師大	台師大 臺師大
臺席	台席 臺席
臺帳	台帳 臺帳
臺幣	台幣 臺幣
臺座	台座 臺座
臺式	台式 臺式
臺式機	台式機 臺式機
臺式電腦	台式電腦 臺式電腦
臺後	台後 臺後
臺意	台意 臺意
臺意怒	台意怒 臺意怒
臺慶	台慶 臺慶
臺成	台成 臺成
臺拉維夫	台拉維夫 臺拉維夫
臺指期	台指期 臺指期
臺收	台收 臺收
臺數	台數 臺數
臺文	台文 臺文
臺斤	台斤 臺斤
臺新	台新 臺新
臺新金	台新金 臺新金
臺新銀	台新銀 臺新銀
臺日	台日 臺日
臺旨	台旨 臺旨
臺服	台服 臺服
臺期指	台期指 臺期指
臺本	台本 臺本
臺東	台東 臺東
臺東人	台東人 臺東人
臺東區	台東區 臺東區
臺東大學	台東大學 臺東大學
臺東市	台東市 臺東市
臺東師範學院	台東師範學院 臺東師範學院
臺東線	台東線 臺東線
臺東縣	台東縣 臺東縣
臺東縣長	台東縣長 臺東縣長
臺板	台板 臺板
臺架	台架 臺架
臺架試驗	台架試驗 臺架試驗
臺柱	台柱 臺柱
臺柱子	台柱子 臺柱子
臺榭	台榭 臺榭
臺槐	台槐 臺槐
臺標	台標 臺標
臺機	台機 臺機
臺步	台步 臺步
臺水澎運	台水澎運 臺水澎運
臺江	台江 臺江
臺江區	台江區 臺江區
臺江縣	台江縣 臺江縣
臺汽	台汽 臺汽
臺汽客運	台汽客運 臺汽客運
臺海	台海 臺海
臺海兩岸	台海兩岸 臺海兩岸
臺海危機	台海危機 臺海危機
臺海局勢	台海局勢 臺海局勢
臺港	台港 臺港
臺港澳	台港澳 臺港澳
臺港澳僑	台港澳僑 臺港澳僑
臺湖	台湖 臺湖
臺澎	台澎 臺澎
臺澎金馬	台澎金馬 臺澎金馬
臺灣	台灣 臺灣
臺灣世界展望會	台灣世界展望會 臺灣世界展望會
臺灣人	台灣人 臺灣人
臺灣人民	台灣人民 臺灣人民
臺灣光復	台灣光復 臺灣光復
臺灣光復節	台灣光復節 臺灣光復節
臺灣共和國	台灣共和國 臺灣共和國
臺灣化	台灣化 臺灣化
臺灣區	台灣區 臺灣區
臺灣台	台灣台 臺灣台
臺灣史	台灣史 臺灣史
臺灣同胞	台灣同胞 臺灣同胞
臺灣味	台灣味 臺灣味
臺灣問題	台灣問題 臺灣問題
臺灣國	台灣國 臺灣國
臺灣國語	台灣國語 臺灣國語
臺灣團	台灣團 臺灣團
臺灣土狗	台灣土狗 臺灣土狗
臺灣地區	台灣地區 臺灣地區
臺灣大學	台灣大學 臺灣大學
臺灣大學附屬醫學院	台灣大學附屬醫學院 臺灣大學附屬醫學院
臺灣女	台灣女 臺灣女
臺灣媒體	台灣媒體 臺灣媒體
臺灣學術網路	台灣學術網路 臺灣學術網路
臺灣居民	台灣居民 臺灣居民
臺灣島	台灣島 臺灣島
臺灣工業技術學院	台灣工業技術學院 臺灣工業技術學院
臺灣師範大學	台灣師範大學 臺灣師範大學
臺灣府	台灣府 臺灣府
臺灣心	台灣心 臺灣心
臺灣教育學院	台灣教育學院 臺灣教育學院
臺灣散打王	台灣散打王 臺灣散打王
臺灣新美術運動	台灣新美術運動 臺灣新美術運動
臺灣方面	台灣方面 臺灣方面
臺灣旅遊	台灣旅遊 臺灣旅遊
臺灣日	台灣日 臺灣日
臺灣日日新報	台灣日日新報 臺灣日日新報
臺灣杜鵑	台灣杜鵑 臺灣杜鵑
臺灣桃園國際機場	台灣桃園國際機場 臺灣桃園國際機場
臺灣歌	台灣歌 臺灣歌
臺灣民主自治同盟	台灣民主自治同盟 臺灣民主自治同盟
臺灣民衆	台灣民衆 臺灣民衆
臺灣水果	台灣水果 臺灣水果
臺灣汽車客運公司	台灣汽車客運公司 臺灣汽車客運公司
臺灣海峽	台灣海峽 臺灣海峽
臺灣海洋大學	台灣海洋大學 臺灣海洋大學
臺灣海洋學院	台灣海洋學院 臺灣海洋學院
臺灣滷肉飯	台灣滷肉飯 臺灣滷肉飯
臺灣版	台灣版 臺灣版
臺灣犬	台灣犬 臺灣犬
臺灣獼猴桃	台灣獼猴桃 臺灣獼猴桃
臺灣玉	台灣玉 臺灣玉
臺灣環頸雉	台灣環頸雉 臺灣環頸雉
臺灣產	台灣產 臺灣產
臺灣當局	台灣當局 臺灣當局
臺灣療養院	台灣療養院 臺灣療養院
臺灣的	台灣的 臺灣的
臺灣省	台灣省 臺灣省
臺灣省政府	台灣省政府 臺灣省政府
臺灣省政府教育廳	台灣省政府教育廳 臺灣省政府教育廳
臺灣省政府林業試驗所	台灣省政府林業試驗所 臺灣省政府林業試驗所
臺灣省政府消防處	台灣省政府消防處 臺灣省政府消防處
臺灣省政府警政廳	台灣省政府警政廳 臺灣省政府警政廳
臺灣省政府財政廳	台灣省政府財政廳 臺灣省政府財政廳
臺灣省立	台灣省立 臺灣省立
臺灣省議會	台灣省議會 臺灣省議會
臺灣社	台灣社 臺灣社
臺灣神學院	台灣神學院 臺灣神學院
臺灣科技大學	台灣科技大學 臺灣科技大學
臺灣籍	台灣籍 臺灣籍
臺灣米	台灣米 臺灣米
臺灣粉蝶	台灣粉蝶 臺灣粉蝶
臺灣精品	台灣精品 臺灣精品
臺灣糖業公司	台灣糖業公司 臺灣糖業公司
臺灣紅	台灣紅 臺灣紅
臺灣經濟	台灣經濟 臺灣經濟
臺灣經驗	台灣經驗 臺灣經驗
臺灣肥料公司	台灣肥料公司 臺灣肥料公司
臺灣航業公司	台灣航業公司 臺灣航業公司
臺灣茶	台灣茶 臺灣茶
臺灣菜	台灣菜 臺灣菜
臺灣葉鼻蝠	台灣葉鼻蝠 臺灣葉鼻蝠
臺灣藍鵲	台灣藍鵲 臺灣藍鵲
臺灣藝人	台灣藝人 臺灣藝人
臺灣藝術專科學校	台灣藝術專科學校 臺灣藝術專科學校
臺灣行	台灣行 臺灣行
臺灣話	台灣話 臺灣話
臺灣證券集中保管公司	台灣證券集中保管公司 臺灣證券集中保管公司
臺灣警察專科學校	台灣警察專科學校 臺灣警察專科學校
臺灣銀行	台灣銀行 臺灣銀行
臺灣鋁業	台灣鋁業 臺灣鋁業
臺灣鋁業公司	台灣鋁業公司 臺灣鋁業公司
臺灣關係法	台灣關係法 臺灣關係法
臺灣隊	台灣隊 臺灣隊
臺灣電力	台灣電力 臺灣電力
臺灣電力公司	台灣電力公司 臺灣電力公司
臺灣電視公司	台灣電視公司 臺灣電視公司
臺灣青年	台灣青年 臺灣青年
臺灣館	台灣館 臺灣館
臺灣高山族	台灣高山族 臺灣高山族
臺灣鳳蝶	台灣鳳蝶 臺灣鳳蝶
臺照	台照 臺照
臺版	台版 臺版
臺獨	台獨 臺獨
臺獨分子	台獨分子 臺獨分子
臺獨運動	台獨運動 臺獨運動
臺玻	台玻 臺玻
臺班	台班 臺班
臺生	台生 臺生
臺甫	台甫 臺甫
臺盆	台盆 臺盆
臺盞	台盞 臺盞
臺盟	台盟 臺盟
臺盤	台盤 臺盤
臺省	台省 臺省
臺磅	台磅 臺磅
臺磯	台磯 臺磯
臺科大	台科大 臺科大
臺積電	台積電 臺積電
臺站	台站 臺站
臺端	台端 臺端
臺簾	台簾 臺簾
臺籍	台籍 臺籍
臺糖	台糖 臺糖
臺糖公司	台糖公司 臺糖公司
臺經院	台經院 臺經院
臺維斯杯	台維斯杯 臺維斯杯
臺網	台網 臺網
臺羅	台羅 臺羅
臺美	台美 臺美
臺聯	台聯 臺聯
臺聯會	台聯會 臺聯會
臺聯黨	台聯黨 臺聯黨
臺股	台股 臺股
臺肥	台肥 臺肥
臺胞	台胞 臺胞
臺胞證	台胞證 臺胞證
臺臺	台台 臺臺
臺航	台航 臺航
臺菜	台菜 臺菜
臺菜餐廳	台菜餐廳 臺菜餐廳
臺華輪	台華輪 臺華輪
臺藝	台藝 臺藝
臺藝大	台藝大 臺藝大
臺號	台號 臺號
臺裝	台裝 臺裝
臺裝貨	台裝貨 臺裝貨
臺製	台製 臺製
臺製品	台製品 臺製品
臺西	台西 臺西
臺西鄉	台西鄉 臺西鄉
臺視	台視 臺視
臺視公司	台視公司 臺視公司
臺設備	台設備 臺設備
臺詞	台詞 臺詞
臺詞功底	台詞功底 臺詞功底
臺語	台語 臺語
臺語歌	台語歌 臺語歌
臺諜	台諜 臺諜
臺諫官	台諫官 臺諫官
臺諱	台諱 臺諱
臺資	台資 臺資
臺資企業	台資企業 臺資企業
臺賬	台賬 臺賬
臺車	台車 臺車
臺車道	台車道 臺車道
臺軍	台軍 臺軍
臺輔	台輔 臺輔
臺辦	台辦 臺辦
臺達	台達 臺達
臺達電	台達電 臺達電
臺金	台金 臺金
臺釣	台釣 臺釣
臺銀	台銀 臺銀
臺銜	台銜 臺銜
臺鋁	台鋁 臺鋁
臺錢	台錢 臺錢
臺鐵	台鐵 臺鐵
臺鐵局	台鐵局 臺鐵局
臺鑒	台鑒 臺鑒
臺鑽	台鑽 臺鑽
臺長	台長 臺長
臺開	台開 臺開
臺閣	台閣 臺閣
臺閣生風	台閣生風 臺閣生風
臺階	台階 臺階
臺電	台電 臺電
臺電公司	台電公司 臺電公司
臺音	台音 臺音
臺風	台風 臺風
臺風穩健	台風穩健 臺風穩健
臺馬輪	台馬輪 臺馬輪
臺駕	台駕 臺駕
臺鳳	台鳳 臺鳳
臺鳳公司	台鳳公司 臺鳳公司
與臺灣	與台灣 與臺灣
興隆臺	興隆台 興隆臺
興隆臺區	興隆台區 興隆臺區
舞榭歌臺	舞榭歌台 舞榭歌臺
舞臺	舞台 舞臺
舞臺上	舞台上 舞臺上
舞臺佈景	舞台佈景 舞臺佈景
舞臺光	舞台光 舞臺光
舞臺劇	舞台劇 舞臺劇
舞臺化	舞台化 舞臺化
舞臺區	舞台區 舞臺區
舞臺戲	舞台戲 舞臺戲
舞臺搭建	舞台搭建 舞臺搭建
舞臺效果	舞台效果 舞臺效果
舞臺演出	舞台演出 舞臺演出
舞臺燈光	舞台燈光 舞臺燈光
舞臺版	舞台版 舞臺版
舞臺秀	舞台秀 舞臺秀
舞臺美術	舞台美術 舞臺美術
舞臺藝術	舞台藝術 舞臺藝術
舞臺音樂	舞台音樂 舞臺音樂
船臺	船台 船臺
花臺	花台 花臺
英國廣播電臺	英國廣播電台 英國廣播電臺
茅臺	茅台 茅臺
茅臺酒	茅台酒 茅臺酒
茅臺酒廠	茅台酒廠 茅臺酒廠
茅臺鎮	茅台鎮 茅臺鎮
草臺	草台 草臺
草臺班子	草台班子 草臺班子
菊花臺	菊花台 菊花臺
萬臺	萬台 萬臺
落臺	落台 落臺
葛朗臺	葛朗台 葛朗臺
蒙臺梭利	蒙台梭利 蒙臺梭利
蒸汽平臺	蒸汽平台 蒸汽平臺
蓮臺	蓮台 蓮臺
藩臺	藩台 藩臺
蘇臺德	蘇台德 蘇臺德
蘇臺德地區	蘇台德地區 蘇臺德地區
蘭臺	蘭台 蘭臺
蘭臺令史	蘭台令史 蘭臺令史
蘭臺公子	蘭台公子 蘭臺公子
蘭臺石室	蘭台石室 蘭臺石室
蠟燭臺	蠟燭台 蠟燭臺
蠟臺	蠟台 蠟臺
血洗臺灣	血洗台灣 血洗臺灣
衆籌平臺	衆籌平台 衆籌平臺
行臺	行台 行臺
被臺灣	被台灣 被臺灣
補臺	補台 補臺
西臺	西台 西臺
西臺人	西台人 西臺人
西臺古堡	西台古堡 西臺古堡
西臺帝國	西台帝國 西臺帝國
親子臺	親子台 親子臺
親臺	親台 親臺
觀光臺	觀光台 觀光臺
觀星臺	觀星台 觀星臺
觀景臺	觀景台 觀景臺
觀望臺	觀望台 觀望臺
觀測臺	觀測台 觀測臺
觀禮臺	觀禮台 觀禮臺
觀臺	觀台 觀臺
觀衆臺	觀衆台 觀衆臺
觀象臺	觀象台 觀象臺
解放臺灣	解放台灣 解放臺灣
訪臺	訪台 訪臺
訪臺之旅	訪台之旅 訪臺之旅
設臺	設台 設臺
試車臺	試車台 試車臺
誦經臺	誦經台 誦經臺
調幅臺	調幅台 調幅臺
調音臺	調音台 調音臺
調頻臺	調頻台 調頻臺
調頻電臺	調頻電台 調頻電臺
諮詢臺	諮詢台 諮詢臺
講臺	講台 講臺
講臺上	講台上 講臺上
謻臺	謻台 謻臺
識面臺官	識面台官 識面臺官
警察廣播電臺	警察廣播電台 警察廣播電臺
讓臺灣	讓台灣 讓臺灣
豐臺	豐台 豐臺
豐臺區	豐台區 豐臺區
貴州茅臺	貴州茅台 貴州茅臺
貴平臺	貴平台 貴平臺
買一臺	買一台 買一臺
買臺	買台 買臺
購物臺	購物台 購物臺
赫麥漢士臺	赫麥漢士台 赫麥漢士臺
走上臺	走上台 走上臺
走下臺	走下台 走下臺
走臺	走台 走臺
走馬章臺	走馬章台 走馬章臺
赴臺	赴台 赴臺
超然臺	超然台 超然臺
趕下臺	趕下台 趕下臺
跨平臺	跨平台 跨平臺
跨平臺開發	跨平台開發 跨平臺開發
跳傘臺	跳傘台 跳傘臺
跳水臺	跳水台 跳水臺
跳臺	跳台 跳臺
跳臺滑雪	跳台滑雪 跳臺滑雪
跳臺跳水	跳台跳水 跳臺跳水
跳臺階	跳台階 跳臺階
車臺	車台 車臺
車載電臺	車載電台 車載電臺
軟件平臺	軟件平台 軟件平臺
輪臺	輪台 輪臺
輪臺古城	輪台古城 輪臺古城
輪臺縣	輪台縣 輪臺縣
輿臺	輿台 輿臺
轉播臺	轉播台 轉播臺
轉臺	轉台 轉臺
轉車臺	轉車台 轉車臺
近水樓臺	近水樓台 近水樓臺
近水樓臺先得月	近水樓台先得月 近水樓臺先得月
返臺	返台 返臺
退出舞臺	退出舞台 退出舞臺
送客臺	送客台 送客臺
逃債臺	逃債台 逃債臺
這一臺	這一台 這一臺
這個平臺	這個平台 這個平臺
這兩臺	這兩台 這兩臺
這臺	這台 這臺
這臺電腦	這台電腦 這臺電腦
速不臺	速不台 速不臺
連臺	連台 連臺
連臺好戲	連台好戲 連臺好戲
連臺本戲	連台本戲 連臺本戲
逼下臺	逼下台 逼下臺
遊臺灣	遊台灣 遊臺灣
運行平臺	運行平台 運行平臺
道臺	道台 道臺
遠臺	遠台 遠臺
遷臺	遷台 遷臺
避風臺	避風台 避風臺
邢臺	邢台 邢臺
邢臺地區	邢台地區 邢臺地區
邢臺市	邢台市 邢臺市
邢臺縣	邢台縣 邢臺縣
那臺	那台 那臺
那臺機器	那台機器 那臺機器
邪馬臺國	邪馬台國 邪馬臺國
郭臺成	郭台成 郭臺成
郭臺銘	郭台銘 郭臺銘
釋迦佛也惱下蓮臺	釋迦佛也惱下蓮台 釋迦佛也惱下蓮臺
重臺	重台 重臺
野臺	野台 野臺
野臺戲	野台戲 野臺戲
金盞銀臺	金盞銀台 金盞銀臺
金粉樓臺	金粉樓台 金粉樓臺
金臺	金台 金臺
金臺區	金台區 金臺區
釣魚臺	釣魚台 釣魚臺
釣魚臺列島	釣魚台列島 釣魚臺列島
釣魚臺國賓館	釣魚台國賓館 釣魚臺國賓館
鉉臺	鉉台 鉉臺
銀臺	銀台 銀臺
銅雀臺	銅雀台 銅雀臺
鍋臺	鍋台 鍋臺
鎮臺	鎮台 鎮臺
鏡框舞臺	鏡框舞台 鏡框舞臺
鏡臺	鏡台 鏡臺
鑽井平臺	鑽井平台 鑽井平臺
鑽井平臺數	鑽井平台數 鑽井平臺數
鑽臺	鑽台 鑽臺
開放平臺	開放平台 開放平臺
開放舞臺	開放舞台 開放舞臺
開發平臺	開發平台 開發平臺
開臺	開台 開臺
開臺聖王	開台聖王 開臺聖王
開臺鑼鼓	開台鑼鼓 開臺鑼鼓
閩臺	閩台 閩臺
閩臺地區	閩台地區 閩臺地區
閱兵臺	閱兵台 閱兵臺
關臺	關台 關臺
陳列臺	陳列台 陳列臺
陽臺	陽台 陽臺
陽臺春夢	陽台春夢 陽臺春夢
陽臺雲雨	陽台雲雨 陽臺雲雨
雙臺子	雙台子 雙臺子
雙臺子區	雙台子區 雙臺子區
雨花臺	雨花台 雨花臺
雨花臺區	雨花台區 雨花臺區
雲平臺	雲平台 雲平臺
雲臺	雲台 雲臺
雲臺山	雲台山 雲臺山
雲計算平臺	雲計算平台 雲計算平臺
電商平臺	電商平台 電商平臺
電子商務平臺	電子商務平台 電子商務平臺
電影臺	電影台 電影臺
電臺	電台 電臺
電臺節目	電台節目 電臺節目
電視臺	電視台 電視臺
霧臺	霧台 霧臺
霧臺鄉	霧台鄉 霧臺鄉
露臺	露台 露臺
露臺上	露台上 露臺上
露臺弟子	露台弟子 露臺弟子
靈臺	靈台 靈臺
靈臺縣	靈台縣 靈臺縣
靑瓦臺	靑瓦台 靑瓦臺
青瓦臺	青瓦台 青瓦臺
靶臺	靶台 靶臺
靶臺上	靶台上 靶臺上
音樂臺	音樂台 音樂臺
頒獎臺	頒獎台 頒獎臺
領獎臺	領獎台 領獎臺
首度來臺	首度來台 首度來臺
首次來臺	首次來台 首次來臺
首臺	首台 首臺
香港電臺	香港電台 香港電臺
馬臺	馬台 馬臺
駐臺	駐台 駐臺
駕駛臺	駕駛台 駕駛臺
騰訊開放平臺	騰訊開放平台 騰訊開放平臺
體育臺	體育台 體育臺
高臺	高台 高臺
高臺盤	高台盤 高臺盤
高臺縣	高台縣 高臺縣
高臺跳水	高台跳水 高臺跳水
高跳臺	高跳台 高跳臺
鬥犀臺	鬥犀台 鬥犀臺
鬥雞臺	鬥雞台 鬥雞臺
鬧臺	鬧台 鬧臺
魏臺復	魏台復 魏臺復
魚臺	魚台 魚臺
魚臺縣	魚台縣 魚臺縣
鳳凰臺	鳳凰台 鳳凰臺
鳳凰臺上鳳凰遊	鳳凰台上鳳凰遊 鳳凰臺上鳳凰遊
鳳去臺空	鳳去台空 鳳去臺空
鳳臺	鳳台 鳳臺
鳳臺縣	鳳台縣 鳳臺縣
鷹架棧臺	鷹架棧台 鷹架棧臺
鹿臺	鹿台 鹿臺
麟臺	麟台 麟臺
黃金臺	黃金台 黃金臺
點將臺	點將台 點將臺
點歌臺	點歌台 點歌臺
鼓臺	鼓台 鼓臺
龍應臺	龍應台 龍應臺
